5 6 2
@@..@@
@@...@
...K@@
@.@@.@
@...|@
K.@@.@
@....@
.@.@.@
@@.@.C
@..@@@
